##################################################
########    ####  ## ########## #       ##########
######  # #   #  ##  ### #####  # # # #A##########
##### #  # # ## #   # ## ####   # # ##############
####    #  # #  ## ## #   ##  #  #    ############
### ###  #      #  #   # # ##  #   ## ############
##      #  ## # # # ## #      #  ##  # ###########
## # ##  #  # ##     #  # ## # #  # #   ##########
#####  # # # #  ## ##  # #   # # #   # # # #######
##   #         #     # #  # #  #  # #         ####
# ## ## # ### # # ##     #   # # #   # ##### #####
# ##   #    ##   ##  # #  # #      ##  #   #######
#    # # # #  # #  # #  ##   # ## #  # # ## ######
# # # # ## # ##  #  # #   ## #   # # #    #   ####
###   #    #    #  #  # #      # #     # #  ## ###
## ## #### ## ####  #  #### # # #  #### # #  #  ##
#           #   # #   # #  ## #  # #      # #  ###
## #### # # ## #  # #     #     #   # ## ##   ####
# #     # #     # # ## ##  ## ##  ##    ##  #   ##
#   # ## # # ## # #   ### ##  #  #  ## #  #  ### #
## # #   # #   #   # # #    #   #  #    #   # #  #
## # # #     ## # # #    # # # # # # ## # #     ##
#  #    # ##      #  # #  #  # #      #    ## #  #
# #  #### ### # #   # #  # #     ## #   ##   ## ##
#######    #   ## # #  # #   # #  # # # # ###  ###
#### #  # # # #   #   #    # # # #   #      # # ##
##    ## #   ## ##  #   # # # ##  ##  ### #      #
### #  #   #    #  ## # #       #   #    #  # ####
##  ##   #  # ##  #   # # # # #  ## # # ###  #   #
# ### # #  # ##  #  #  #  #  #       #   # ##  ###
# #     # #     # #  #  ##  # #  # # ## #     ####
#   # #  #  ## ## # #  #  #   # #  ##     # #   ##
### # ###  #   #     #  #   ## # #   ## #  #  ####
#### #    #  #  ### #  ## #       ##   # # # # ###
####   # #  #  #     # #   # ## #   # ##    #  ###
# #  # # ## # # ## #  # # #    ### #  #  ##   # ##
#   #   #  #     ##  #     # ## ##  #  ## ##     #
### ###  #   # ##   #  # # #      # ##      # ####
### ### # ## # #  #  #  #  # # # #    ## ###   ###
########      #  #  # #  ##   #   # # #    # # ###
############ #  # #   ##    #  # #  #  # #  ## ###
########     # ##  # #  ## #  #  # # # #  ########
############ #    #  ##    ##  # ##  #  #   ######
########      ## ## ##  ##  # #   # # #  #########
######## # # ##  ### ## #  #   ##      # #########
##########  #### ###    # ###     # ###  #########
#########  ########### #  ##  # #  ###############
############ ######## #  #   #   #################
########################  ## B## #################
##################################################
